######## ################### ##############
#    F    F                 C         #   #
#                                     # R #
#     ##################       ########  C#
#     #         R      #     F        #   #
#     # F     #        #    ###       #   #
      #      #####     #    #     #       #
#     #######        ###    ###   #       #
# R                               #  ##   #
#      ####                  #    #        
 #####################   ##################
