######## ################### ##############
#    F    F                 C         #   #
#                                     # R #
#     ##################       ########   #
#     #         R      #     F        #   #
#     # F     #        #    ###       #   #
      #      #####     #    #     #       #
#     #######        ###    ###   #       #
# R                               #  ##   #
#      ####                  #    #     C  
 #####################   ##################
